51 51
%%%%%%%%%%%%%%%%%%%%%%%%%%%%%%%%%%%%%%%%%%%%%%%%%%%
%   %               %   %     %   %         %    S%
%%% % % %%%%%%%%% % % % % % %%% % % %%%%% %%% %%% %
%   % % %   %   % %   % % %     % % %   %   % % % %
% %%%%% % % % % %%%%%%% % %%%%%%% % %%% %%% % % % %
%   %   % %   %     %     %   % % %   %     %   % %
%%% % %%%%%%% %%%%%%% %%%%%%% % % %%% % %%%%%%%%% %
% % % % %   %           %   % %   % % % %       % %
% % % % % % %%%%%%%%%%% % % % % %%% % % %%%%%%% % %
% %   %   %       %     % %   % %   % % %   %   % %
% %%%%%%% %%%%%%% % %%%%% %%%%% % %%% % % % % %%% %
%   %     %     %   %   %     % % %   %   %   %   %
%%% % %%%%%%%%% % %%%%% % %%% % % %%% %%%%%%%%% %%%
%       %   %   %   %   %   %   %       %   %   % %
%%%%% % %%% % %%%%% % %%%%% % %%%%%%% %%% % % %%% %
%     % %   %     % %       % %   %   %   %   %   %
% %%%%% % %%%%%%% % %%%%%%%%% % % % %%% %%%%%%%%% %
% %     % %   % % % %   %   % % % %             % %
% % %%%%% % % % % % % % % % % %%% %%% % %%%%%%% % %
% % %   % % % % % % % % % % %     %   % %       % %
% % %%% % % % % % %%% % % % %%%%%%%%%%% %%%%%%%%% %
% %         %   %   % % % %     %     %   % %     %
% %%%%%%% %%%%%%%%% % % %%% %%% % %%% %%% % % %%%%%
%   %           %   % %   %   %   %   %     %   % %
%%% %%%%%%%%%%%%% % %%% % %%% %%%%% %%%%%%% % % % %
%   %     %     % % %   %   % %     %   % % % % % %
% %%% %%% % %%% % % % %%%%% %%% %%%%% % % % % % % %
%   % % %   %   % % %     %     %   % % % % % % % %
%%% % % % %%% %%%%% %%%%% %%%%%%% % % % % % %%% % %
%   % %   %   % %   %   %         %   % %     % % %
% %%% %%%%% %%% % %%% % %%%%%%% %%%%%%% %%% % % % %
%     %     %   %     %     %   %     %   % % %   %
%%%%%%% %%%%% %%%%% %%%%%%% % % % %%%%%%% %%% %%% %
%     %   % %       %     % % % %       % %     % %
% %%% %%% % %%% % %%% %%% % % %%%%%%%%% % % %%% % %
% % % % %       %   %   %   % %     % % %   %     %
% % % % %%% %%%%%%% %%%%%%%%% % %%% % % %%%%% % %%%
% %   %     %   % %   %       % %   % %   % % %   %
% %%%%%%%%%%% % % %%% % %%%%%%%%% %%% %%% % % %%%%%
% %       %   %     % % %   %       %       % %   %
% % % %%% % % %%%%%%% % %%% %%%%% % %%%%% %%% % % %
%   %   %   %           %   %     %       % % % % %
%%%%%%% %%%%%%%%%%%%% %%% %%% % %%%%%%%%%%% % %%% %
%   %   %     %     %     %   % %     %   %       %
% % % %%% %%% % %%% %%% %%% %%% % %%% %%% %%% %%%%%
% %   % %   % % %   %   % % % %   % %     %   %   %
% %%%%% % %%% %%% %%% %%% % % %%%%% %%%%%%% %%% % %
% %   %   %   %   %   %   %           %   %   % % %
% % % %%% % %%% % % %%% % %%% %%%%%%% % % % % % % %
%E  %     %     % %     %     %       % %   %   % %
%%%%%%%%%%%%%%%%%%%%%%%%%%%%%%%%%%%%%%%%%%%%%%%%%%%